.*******.*
.......*.*
.*****.*.*
.*...*....
.*.*.*.*.*
.*.*.*.*.*
.*.*.*.*.*
.*.*...*.*
.*.*.***.*
..........