.*.*****.*.*
.........*.*
.*******.*.*
.*.....*.*.*
.*.***.*.*.*
.*...*.*.*..
.***.*.*.*.*
.*.*.*...*.*
.*.*.*****.*
.*.*.......*
.*.*.*****.*
............