.***.***.*****
.......*.....*
.*****.*****.*
.*.......*...*
.*.*****.*.***
...*.....*.*..
.***.*.***.*.*
.....*.......*
.***.*.***.***
.*.*.*...*....
.*.*.*.*.*****
.*...*.*.....*
.*****.*****.*
..............